11111111111111
10010000000011
1000P01CE00001
11111111111111