1111111111111
1111111111111
10000000000P1
11111C1111111
10000000000E1
1111111111111