11111111111111
10P10000100E11
1C00C010000001
11111111111111