11111111111111
1P010000100E11
1000C010000001
11111111111111