11111111111111
1001C000100011
10P00010000E01
11111111111111