11111111111111
1001C000100P11
10N00010000E01
11111111111111