1111111111111111111111111
100100000000000000C000001
100001111100000000C000001
1P0011E00000000000C000001
100000000000000N00C000001
100000N00000000000C000001
100000000000000000C000001
1000000000000N0000C000001
100001111100000000C000001
100001111100000000C000001
100001111100000000C000001
1000011111000N0000C000001
100001111100000000C000001
1111111111111111111111111